NAME A big proot

PLAYER A
PLAYER B
PLAYER C

X 19
Y 21

MAP

# WXXYZ
# W ¤ {'v', 'V', 't', 'm', 'p' }
# XX ¤ ['AA';'ZZ']
# Y ¤ {'A', 'B', 'D' }
# Z ¤ R
#    #    #
mAAAmmAAAmmAAAmmAAAmmAAAmmAAAmmAAAmmAAAmmAAAmmAAAmmBABmmBABmmCACmmCACmmCACmmCACmmCACmmCACmmCACm
mAAAmmAAAmmAAAmmAAAmmAAAmmAAAmmAAAmmAAAmmAAAmmAAAmmBABmmBABmmCACmmCACmmCACmmCACmmCACmmCACmmCACm
mAAAmmAAAmmAAAmmAAAmmAAAmmAAAmmAAAmmAAAmmAAAmmAAAmmBABmmBABmmCACmmCACmmCACmmCACmmCACmmCACmmCACm
mAAAmmAAAmmAAAmmAAAmmAAAmmAAAmmAAAmmAAAmmAAAmmAAAmmBABmmBABmmCACmmCACmmCACmmCACmmCACmmCACmmCACm
mAAAmmAAAmmAAAmmAAAmmAAAmmAAAmmAAAmmAAAmmAAAmmAAAmmBABmmBABmmCACmmCACmmCACmmCACmmCACmmCACmmCACm
mAAAmmAAAmmAAAmmAAAmmAAAmmAAAmmAAAmmAAAmmAAAmmAAAmmBABmmBABmmCACmmCACmmCACmmCACmmCACmmCACmmCACm
mAAAmmAAAmmAAAmmAAAmmAAAmmAAAmmAAAmmAAAmmAAAmmAAAmmBABmmBABmmCACmmCACmmCACmmCACmmCACmmCACmmCACm
mAAAmmAAAmmAAAmmAAAmmAAAmmAAAmmAAAmmAAAmmAAAmmAAAmmBABmmBABmmCACmmCACmmCACmmCACmmCACmmCACmmCACm
mAAAmmAAAmmAAAmmAAAmmAAAmmAAAmmAAAgmAAAbmAAAbmAAAbmBABbmBABbmCACbmCACbmCACbmCAChmCACmmCACmmCACm
mAAAmmAAAmmAAAmmAAAmmAAAmmAAAmmAAAdtAAAttAAAttAAAttBABttBABttCACttCACttCACtmCACcmCACmmCACmmCACm
mAAAmmAAAmmAAAmmAAAmmAAAmmAAAmmAAAdtAAAtvAAAvtAAAtvBABvtBABtvCACvtCACttCACtmCACcmCACmmCACmmCACm
mABAmmABAmmABAmmABAmmABAmmABAmmABAdtABAttABAtVABAVtBBBtVBBBVtCACttCACtmCACjmCACemCACmmCACmmCACm
mABAmmABAmmABAmmABAmmABAmmABAmmABAdtABAttABAttABAttBBBttBBBtVCBCVtCBCtmCBCcmCACmmCACmmCACmmCACm
mABAmmABAmmABAmmABAmmABAmmABAmmABAfmABAitABAttABAttBBBttBBBttCBCttCBCtmCBCcmCACmmCACmmCACmmCACm
mABAmmABAmmABAmmABAmmABAmmABAmmABAmmABAfmABAamABAamBBBamBBBamCBCamCBCamCBCemCACmmCACmmCACmmCACm
mABAmmABAmmABAmmABAmmABAmmABAmmABAmmABAmmABAmmABAmmBBBmmBBBmmCBCmmCBCmmCBCmmCACmmCACmmCACmmCACm
mABAmmABAmmABAmmABAmmABAmmABAmmABAmmABAmmABAmmABAmmBBBmmBBBmmCBCmmCBCmmCBCmmCACmmCACmmCACmmCACm
mABAmmABAmmABAmmABAmmABAmmABAmmABAmmABAmmABAmmABAmmBBBmmBBBmmCBCmmCBCmmCBCmmCACmmCACmmCACmmCACm
mABAmmABAmmABAmmABAmmABAmmABAmmABAmmABAmmABAmmABAmmBBBmmBBBmmCBCmmCBCmmCBCmmCACmmCACmmCACmmCACm
mABAmmABAmmABAmmABAmmABAmmABAmmABAmmABAmmABAmmABAmmBBBmmBBBmmCBCmmCBCmmCBCmmCACmmCACmmCACmmCACm
mABAmmABAmmABAmmABAmmABAmmABAmmABAmmABAmmABAmmABAmmBBBmmBBBmmCBCmmCBCmmCBCmmCACmmCACmmCACmmCACm


EOM

BEGIN 15000
CITY 1000
MIN 2
MAX 3
DATE 13 08 1988

SOLDATS 1000

INFO Alors
INFO
INFO Cette map sent la moule fraiche.
INFO En effet elle présente une petite ile de merde
INFO où il n'y a que deux joueurs.
INFO Oui, elle ne sert à rien !
INFO
INFO En effet, c'est une map de test !
INFO
INFO Bon encore quelques lignes,
INFO juste histoire de faire un
INFO peu déborder le TMemo !!
INFO
INFO Ça devrait être bon là, non ?
INFO Allez, stop !!!
INFO
INFO Note: ça pue
